11111111111111111111111111111111
1..............................1
1..........C...................1
1.........................M....1
1..............................1
1.......11111......11111.......1
1.......1..............1.......1
1.......1..............1.......1
1.......1..............1.......1
1.......1..............1...C...1
1............M.................1
1...C..........................1
1..............C...............1
1..............................1
1.......1..............1.......1
1.......1..............1.......1
1.......1..............1.......1
1.......1..............1.......1
1.......11111......11111.......1
1...M..........................1
1.......................C......1
1....C........P................1
1..............................1
11111111111111111111111111111111